#############
#E  S  ### ##
# #### ### ##
# #### ### ##
# #### ### ##
# #### ### ##
###### ### ##
#          ##
# ###########
#           #
#############